.o..o......o..o.
o..o...o...o....
................
.o...o...o..o...
.....o.........o
...o...o..o.....
.o...o..........
..o..o.S.o..o...
............o...
...o...o..o..o..
o..........o....
.o..o..o..o.o...
......o......E..
.o..o..o.o.o..o.
.o.o.....o...o..