.oo.............
o.oEo.ooo.ooo...
...o.o.o.o......
..o...o...oooo..
.....o...o......
....o.....o.....
...o.......o....
..o.........o...
.o...........o..
.....oS......oo.
........o....o..
..o..........o..
.o........o.oo..
....o....o.o.o..
..o............o